Population
3032156070
3071596055
3124561005
3189655687
3255145692
3322046795
3392097729
3461619724
3532782993
3606553753
3681975908
3760516757
3836900801
3912984371
3988487336
4062507027
4135432265
4207786422
4281339378
4356778367
4432963653
4511164132
4592387213
4674330282
4755996689
4839176734
4924747934
5012556248
5101287675
5189977062
5280046096
5368139468
5452576447
5537885552
5622085788
5706753900
5789655609
5872286683
5954005906
6034491620
6114332517
6193671694
6272753009
6351882385
6431551721
6511748273
6592734559
6674203697
6757020825
6839574233
6921877071
7002880914
7085790438
7169675197
7254292848
7339076654
7424484741
7509410228
7592475615
7673345391
7752840547
